00000000000000000000000
00000000000000000000000
00000000000000000000000
00000000000000000000000
00000000000000000000000
11111111111111111111111
11111112222222211111111
11111111111111111111111
11111111111111111111111
11111111111111111111111