1111111000000000000000000000000
1111111000001111110000000000011
1111111000001111111111111111111
1111111000001111111111111111111
1111111000001111111111111111111
1111111000001111111111111111111