00000000000000000000000000000000000000000000000000000000000000000000000000000000000000000000000000000000000000000000
00000000000000000000000000000000000000000000000000000000000000000000000000000000000000000000000000000000000000000000
00000000000000000000000000000000000000000000000000000000000000000000000000000000000000000000000000000000000000000000
00000000000000000000000000000000000000000000000000000000000000000000000000000000000000000000000000000000000000000000
00000000000000000000000000000000000000000000000000000000000000000000000000000000000000000000000000000000000000000000
00000000000000000000000000000000000000000000000000000000000000000000000000000000000000000000000000000000000000000000
00000000000000000000000000000000000000000000000000000000000000000000000000000000000000000000000000000000000000000000
00000000000000000000000000000000000000022222222220000000000000000000000000000000222222222222222200000000000000000000
00000000000000000000000000000000000000000000000000000000000000000000000000000000000000000000000000000000002222222222
00000000000000000000000000000000000000000000000000000000222222222222222200000000000000000000000000000000000000000000
0000000000000000000000000000000000000000gggggggg00000000000000000000000000000000000000000000000000000000000000000000
11111111111111111111111111110001111111111111111111111111111111111111111111111111111111111111111111111111111111111111
11111111111111111111111111110001111111111111111111111111111111111111111111111111111111111111111111111111111111111111
11111111111111111111111111110001111111111111111111111111111111111111111111111111111111111111111111111111111111111111
11111111111111111111111111110001111111111111111111111111111111111111111111111111111111111111111111111111111111111111