 12121 
1 121 1
1 121 1
1121211
1 111 1
11   11
 11111 