10000000000000000000000
10000000002220000000011
10000000000000000000111
10000000000000000000111
10000000000000000011111
11111111111111111111111
11111111111111111111111
11111111111111111111111
11111111111111111111111
11111111111111111111111