00000000000000000000000
00000000000000000000000
00000000000000000000000
00000000000000000000000
00000000000000000000000
00000000000000000000000
00000000000000000000000
00222200000000000000000
00000000000000000000g00
00000000000000000000g00
00000000000000000000g00
11110001000000000000001
11110001111000000001111
11110001111111111111111
11110001111111111111111