00000000000000000000000
00000000000gggggggggg00
00000001222222222222221
11110001111111111111111
11110001111111111111111
11110001111111111111111