000000000000000000000000000000000000000000000
000000000000000000000000000000000000000000000
000000000000000000000000000000000000000000000
000000000000000000000000000000000000000000000
000000000000000000000000000000000000000000000
000000000000000000000000000000000000000000000
000000000000000000000000000000000000000000000
000000000000000000000000002222222222000000000
000000000000000340000000000000000000000000034
00000034000g000560000000000000000000000000056
00000056000g0005600000000j000j0000j00j0j00056
111111111111111561111111111111111111111111156
111111111111111561111111111111111111111111156
111111111111111561111111111111111111111111156
111111111111111561111111111111111111111111156