111111100000000000000000
111111100000111111000000
111111100000111111111111
111111100000111111111111
111111100000111111111111
111111100000111111111111