000000000000000000000000000000000000000000000
000000000000000000000000000000000000000000000
000000000000000000000000000000000000000000000
000000000000000000000000000000000000000000000
000000000000000000000000000000000000000000000
000000000000000000000000000000000000000000000
00000000000000000000000000000000j000000000000
000000000000000000000000002222222222000000000
000000000000000340000000000000000000000000034
000000340000000560000000000000000000000000056
0000005600000005600000000j000j0000j00j0j00056
111111111111111561111111111111111111111111156
111111111111111561111111111111111111111111156
111111111111111561111111111111111111111111156
111111111111111561111111111111111111111111156