000000000000000000000000000000000000000000000
000000000000000000000000000000000000000000000
000000000000000000000000000000000000000000000
000000000000000000000000000000000000000000000
000000000000000000000000000000000000000000000
000000000000000000000000000000000000000000000
000000000000000000000000000000000000000000000
00000000000000000000000000bbbbbbbbbb000000000
00bbb0000000000340000000000000000000000000034
00000034000g000560000000000000000000000000056
00000056000g0005600000000g000g0000g00g0g00056
111111111111111561111111111111111111111111156
111111111111111561111111111111111111111111156
111111111111111561111111111111111111111111156
111111111111111561111111111111111111111111156