000000000000000000000000000000000000000000000
000000000000000000000000000000000000000000000
000000000000000000000000000000000000000000000
000000000000000000000000000000000000000000000
000000000000000000000000000000000000000000000
000000000000000000000000000000000000000000000
000000000000000000000000000000000000000000000
000000000000000000000000002222222222000000000
000000000000000340000000000000000000000000034
000000340000000560000000000000g00000000000056
000000560000g00560000000000000g00000000000056
111111111111111561111111111111111111111111156
111111111111111561111111111111111111111111156
111111111111111561111111111111111111111111156
111111111111111561111111111111111111111111156